##########
#.......B#
#....##..#
#.....####
#........#
########.#
#........#
#A.......#
##########
