##########
#.......B#
#........#
#........#
#........#
#........#
#........#
#A.......#
##########
